1111111111111111111
1E00110000100010101
1110101011101110101
1000000000100110001
1110101110101000101
1100111111101110101
1110000000111111111
1100101110000000111
1110101110111110101
10001010000000100S1
1111111111111111111